cccccccccccccccccccccccccccccccccccccccc
r000000000000r0000000000000000000000000l
r000000000000r0000000000000000000000000l
r000000000000r0000000000000000000000000l
r000000000000r0p000000000000000000000d0l
r0000000000k0r0000000000000000000000000l
ff0000ffffffffffffffff00000000000fffffff
r0f0000000000000000000000000000ff000000l
r00f0000000000000000000000000ff00000000l
r000f0000000000000000000000ff0000000000l
r0000f00000000000000000000f000000000000l
r00000f000ffffff0000000fffl000000000000l
ffffffffff000000000r000000l000000000000l
r00000000000000000fr000000l000000000000l
r0000000000000000f0r000000lccccccccccccc
r00000000000ffffffff0000000000000000000l
r0000ff0000f000000000000000000000000000l
r000000f0000000000000000000000000000000l
r0000000f000000000000000000000000000000l
r00000000ffff00000000000000000000000b00l
f000ffffffffffffffffffffffffffffffffffff
